Watch your steps.
da+
6 14
WWWWWWWWWWWWWW
WP...........W
WW0110110001yW
WW..........WW
WW0000000000WW
WWWWWWWWWWWWWW